15 15
0 0 0 0 0 0 0 0 0 0 0 0 0 0 0 
0 0 0 0 0 0 0 0 0 0 0 0 0 0 0 
0 2 2 2 2 2 0 0 0 0 0 0 0 0 0 
4 9 10 8 10 12 1 0 0 0 0 0 0 0 0 
4 5 15 5 15 5 1 0 0 0 0 0 0 0 0 
4 1 10 0 10 4 1 0 0 0 0 0 0 0 0 
4 5 15 5 15 5 1 0 0 0 0 0 0 0 0 
4 3 10 2 10 6 1 0 0 0 0 0 0 0 0 
0 8 8 8 8 8 0 0 0 0 0 0 0 0 0 
0 0 0 0 0 0 0 0 0 0 0 0 0 0 0 
0 0 0 0 0 0 0 0 0 0 0 0 0 0 0 
0 0 0 0 0 0 0 0 0 0 0 0 0 0 0 
0 0 0 0 0 0 0 0 0 0 0 0 0 0 0 
0 0 0 0 0 0 0 0 0 0 0 0 0 0 0 
0 0 0 0 0 0 0 0 0 0 0 0 0 0 0 
