15 15
13 1 0 0 0 0 0 0 0 0 0 0 0 0 0 
5 1 0 0 0 0 0 0 0 2 0 0 0 0 0 
5 1 0 0 0 0 0 0 4 13 1 0 0 0 0 
5 3 2 2 2 2 2 2 4 5 1 0 0 0 0 
3 10 10 10 10 10 10 14 5 5 1 0 0 0 0 
8 8 8 8 8 8 8 8 4 5 1 0 0 0 0 
0 0 0 0 0 0 0 0 4 7 1 0 0 0 0 
0 0 0 0 0 0 0 0 0 8 0 0 0 0 0 
0 0 0 0 0 0 0 0 0 0 0 0 0 0 0 
0 0 0 0 0 0 0 0 0 0 0 0 0 0 0 
0 0 0 0 0 0 0 0 0 0 0 0 0 0 0 
0 0 0 0 0 0 0 0 0 0 0 0 0 0 0 
0 0 0 0 0 0 0 0 0 0 0 0 0 0 0 
0 0 0 0 0 0 0 0 0 0 0 0 0 0 0 
0 0 0 0 0 0 0 0 0 0 0 0 0 0 0 
